00000000000000000000
00000000000000000000
00000000000000000000
00000000000000000000
00000000000000000000
000www00000000000000
000www00000000000000
000www00000000000000
000www00000000000000
00000000000000000000
000000000000ddd00000
000000000000ddd00000
000000000000ddd00000
00000000000000000000
00000000000000000000
0000rrrrrrr000000000
00000000000000000000
00000000000000000000
00000000000000000000
00000000000000000000